arena 64 48 10
000000000000000000000000000000010000000000000000
010000000000000000101000000000000000000000000000
000000000000000000000000000000000000000000000000
100100000001000000000100100000000000000000000000
000000000000000000000000000000000000000000000000
000010000000000000000000000000000000000000100000
000000000000000000000001010010000000000000000000
000000001010000000000001000000000000001100000000
000000000010000010000100000000010000000000000010
000000000000001000010000000000000000000000000000
000100000000001101000000000000000000000101000000
000000000000000000000000000000000000000000000010
000000001000000000010000000000000100000100000000
010110000000000000010000010000000000000010000000
000000010010000000000000000000001000000000000000
000000000000000010000000000000000000010000000100
000100001000000000100000000000000000000000000000
000001000001000000000000000000000000000000000000
100000000000000100000000100000010000000000000000
000000000000000010000000000000000000000100000000
100000000000100000000000000000000000000001000000
000000000000011000000100000100000000000000000000
000000000000000000000001000000000000000000000000
000000000010000000000000000000000000000000000000
000000000000001000000000000000000100000000001000
000000001000000000000000000000000000000000000001
000000000000001000000000000011100100000000000000
100000000000000000000000000000000000100000000000
000000000000010000000000000000100000000100001000
000000000000000000000000000000000010000000000101
000000000000000000001000000000000000000000000000
000000000000000000000000000010000000000001000000
000010000000001000000000000000000000000000000000
000000000000000000000000000000000000000000000000
000000000000000000000000000000000000001000000000
000000000000000000000010000000000000000101000000
000000000000000100000000000000000000000000000000
000010000000000001000000000000000000000000001000
000000000000000000000000000000000010000000010000
000000000000000000100000000000000001000100100000
000000000000000000000100000011010001000010000000
000000000000000000000000000000000000000000000100
000000000000000001000000000000000000000000000010
001000000000000000000100000000000000000000000000
000000000000000000000000000000100000000000000000
000000000000000100000010000000000000000000000000
000101001000000000000000000000000001010000000000
000000000000000100000000000000000000000000000000
000000000000000000000000000001000000000000000000
000000010000000000000000000000100000100000000000
000000000000000000000000000000000000000000000010
000010000000000000000000000000000000000000000000
000000100000000000000000000000001100000000000000
000000000000000000000000100000000000100000000000
110000000000000000000000000001000000000000000000
000000000000000000000100000001000000000000000000
000000000000000000000000000000000000000000000000
000000000100000000000000000000000000000000000000
000100000000000000000000000000000000100000001000
000010000000000000100000000100010100000001000000
000000000001000000000000000000000000010000000010
000000000000000000000000000000001000000000000000
000000000000000000000000000000000000000000000000
000000000000000000000000000000000000000000000100
